1111111111
10E0100001
10000C1001
1CCC100P01
1111111111
