11111
10E01
10P01
1CCC1
11111
